##..######################
#..................#.....#
#........c.........#......
#..................#......
x.....########.....#...###
x.....x............#.....#
x.....x....x...x...x.....#
x.....x............#.....#
x.....x....b...b...x..b..#
x.....x............#.....#
x.....x....x...x...x.....#
x.....x....#########.....#
x.....x..................#
x.....x..................#
xxxxxxx####xx###xx###xx###
